#######################################
# Syntax Coloring Map For DFR0534
#######################################

#######################################
# Datatypes (KEYWORD1)
#######################################

DFR0534	KEYWORD1

#######################################
# Methods and Functions (KEYWORD2)
#######################################

decreaseVolume	KEYWORD2
fastBackwardDuration	KEYWORD2
fastForwardDuration	KEYWORD2
getDrive	KEYWORD2
getDrivesStates	KEYWORD2
getDuration	KEYWORD2
getFileName	KEYWORD2
getFileNumber	KEYWORD2
getFirstFileNumberInCurrentDirectory	KEYWORD2
getRuntime	KEYWORD2
getStatus	KEYWORD2
getTotalFiles	KEYWORD2
getTotalFilesInCurrentDirectory	KEYWORD2
increaseVolume	KEYWORD2
insertFileByNumber	KEYWORD2
pause	KEYWORD2
play	KEYWORD2
playCombined	KEYWORD2
playFileByName	KEYWORD2
playFileByNumber	KEYWORD2
playLastInDirectory	KEYWORD2
playNext	KEYWORD2
playNextDirectory	KEYWORD2
playPrevious	KEYWORD2
prepareFileByNumber	KEYWORD2
repeatPart	KEYWORD2
setChannel	KEYWORD2
setDirectory	KEYWORD2
setDrive	KEYWORD2
setEqualizer	KEYWORD2
setLoopMode	KEYWORD2
setRepeatLoops	KEYWORD2
setVolume	KEYWORD2
startSendingRuntime	KEYWORD2
stop	KEYWORD2
stopCombined	KEYWORD2
stopInsertedFile	KEYWORD2
stopRepeatPart	KEYWORD2
stopSendingRuntime	KEYWORD2

#######################################
# Constants (LITERAL1)
#######################################

CHANNELMP3	LITERAL1
CHANNELAUX	LITERAL1
CHANNELMP3AUX	LITERAL1
CHANNELUNKNOWN	LITERAL1
DRIVEUSB	LITERAL1
DRIVESD	LITERAL1
DRIVEFLASH	LITERAL1
DRIVENO	LITERAL1
DRIVEUNKNOWN	LITERAL1
LOOPBACKALL	LITERAL1
SINGLEAUDIOLOOP	LITERAL1
SINGLEAUDIOSTOP	LITERAL1
PLAYRANDOM	LITERAL1
DIRECTORYLOOP	LITERAL1
RANDOMINDIRECTORY	LITERAL1
SEQUENTIALINDIRECTORY	LITERAL1
SEQUENTIAL	LITERAL1
PLAYMODEUNKNOWN	LITERAL1
NORMAL	LITERAL1
POP	LITERAL1
ROCK	LITERAL1
JAZZ	LITERAL1
CLASSIC	LITERAL1
EQUNKNOWN	LITERAL1
STOPPED	LITERAL1
PLAYING	LITERAL1
PAUSED	LITERAL1
STATUSUNKNOWN	LITERAL1